tipos	tipas
tipazos	tipazas
presidentes	presidentas
ejecutivos	ejecutivas
negociantes	negociantas
hijos	hijas
hijtos	hijitas
mijos	mijas
mijitos	mijitas
intendentes	intendentas
viceintendentes	viceintendentas
manicuros	manicuras
doctorcitos	doctorcitas
mayorcitos	mayorcitas
nuevecitos	nuevecitas
exponedores	exponedoras
arbitradores	arbitradoras
criticones	criticonas
criticastros	criticastras
criticadores	criticadoras
figurantes	figurantas
muertos	muertas
dormidos	dormidas
atentos	atentas
disciplinarios	disciplinarias
disciplinados	disciplinadas
depositadores	depositadoras
adoptadores	adoptadoras
usuarios	usuarias
conocidos	conocidas
amigos	amigas
amiguitos	amiguitas
reyes	reinas
virreyes	virreinas
zares	zarinas
papas	papisas
zagales	zagalas
eclesiásticos	eclesiásticas
provicarios	provicarias
vicarios	vicarias
infiltrados	infiltradas
mercaderes	mercaderas
penitentes	penitentas
espadachines	espadachinas
eugenésicos	eugenésicas
regentes	regentas
pretendientes	pretendientas
concertinos	concertinas
farsantes	farsantas
pajareros	pajareras
groseros	groseras
bedeles	bedelas
funámbulos	funámbulas
académicos	académicas
antipáticos	antipáticas
autoritarios	autoritarias
danzantes	danzantas
palabreros	palabreras
filántropos	filántropas
zoroástricos	zoroástricas
fernandinos	fernandinas
liantes	liantas
éticos	éticas
cronólogos	cronólogas
pedicuros	pedicuras
confederados	confederadas
antiacadémicos	antiacadémicas
anti-académicos	anti-académicas
bolivarianos	bolivarianas
micrográficos	micrográficas
humanos	humanas
favoritos	favoritas
malditos	malditas
individuos	individuas
clientes	clientas
exclientes	exclientas
exnovios	exnovias
ex-novios	ex-novias
jugadores	jugadoras
soldadores	soldadoras
jefes	jefas
escritores	escritoras
técnicos	técnicas
ministros	ministras
campeones	campeonas
viejos	viejas
viejecitos	viejecitas
darwinianos	darwinianas
físicos	físicas
dones	doñas
candidatos	candidatas
alcaldes	alcaldesas
enviados	enviadas
queridos	queridas
famosos	famosas
famosillos	famosillas
secretarios	secretarias
servidores	servidoras
científicos	científicas
navegadores	navegadoras
productores	productoras
enemigos	enemigas
propietarios	propietarias
capitanes	capitanas
editores	editoras
alumnos	alumnas
dueños	dueñas
encargados	encargadas
socios	socias
fundadores	fundadoras
europeos	europeas
diputados	diputadas
críticos	críticas
pintores	pintoras
patrones	patronas
lindos	lindas
conductores	conductoras
marítimos	marítimas
obispos	obispas
gatos	gatas
perros	perras
perritos	perritas
curiosos	curiosas
meticulosos	meticulosas
escrupulosos	escrupulosas
minuciosos	minuciosas
músicos	músicas
americanos	americanas
samoamericanos	samoamericanas
empresarios	empresarias
trabajadores	trabajadoras
locos	locas
detenidos	detenidas
condes	condesas
vecinos	vecinas
administradores	administradoras
expertos	expertas
delanteros	delanteras
creadores	creadoras
gigantes	gigantas
santos	santas
invitados	invitadas
desconocidos	desconocidas
latinos	latinas
funcionarios	funcionarias
jurados	juradas
consumidores	consumidoras
vicepresidentes	vicepresidentas
acusados	acusadas
desaparecidos	desaparecidas
externos	externas
investigadores	investigadoras
mantenidos	mantenidas
lógicos	lógicas
teutones	teutonas
sucesores	sucesoras
condenados	condenadas
papás	mamás
universitarios	universitarias
asistentes	asistentas
enfermos	enfermas
casados	casadas
gerentes	gerentas
subgerentes	subgerentas
exgerentes	exgerentas
fotógrafos	fotógrafas
revolucionarios	revolucionarias
animalísticos	animalísticas
senadores	senadoras
enamorados	enamoradas
embajadores	embajadoras
creativos	creativas
convencidos	convencidas
espectadores	espectadoras
defensores	defensoras
operadores	operadoras
asesores	asesoras
judíos	judías
vendedores	vendedoras
séptimos	séptimas
dependientes	dependientas
diablos	diablas
mandatarios	mandatarias
lobos	lobas
lobitos	lobitas
porteros	porteras
profetas	profetisas
corredores	corredoras
concejales	concejalas
monos	monas
derrotados	derrotadas
agregados	agregadas
sanitarios	sanitarias
pastores	pastoras
leones	leonas
colaboradores	colaboradoras
protectores	protectoras
químicos	químicas
adoptados	adoptadas
monitores	monitoras
republicanos	republicanas
moderados	moderadas
mecánicos	mecánicas
herederos	herederas
aficionados	aficionadas
rectores	rectoras
tontos	tontas
tontitos	tontitas
tramposos	tramposas
traicioneros	traicioneras
embusteros	embusteras
nietos	nietas
nietitos	nietitas
holandeses	holandesas
domésticos	domésticas
ciegos	ciegas
informáticos	informáticas
viajeros	viajeras
matemáticos	matemáticas
ancianos	ancianas
goleadores	goleadoras
ferroviarios	ferroviarias
sabios	sabias
controladores	controladoras
conservadores	conservadoras
dragones	dragonas
innovadores	innovadoras
anónimos	anónimas
obreros	obreras
flamencos	flamencas
narradores	narradoras
compradores	compradoras
guerreros	guerreras
gallegos	gallegas
voluntarios	voluntarias
dictadores	dictadoras
parlamentarios	parlamentarias
gordos	gordas
bibliotecarios	bibliotecarias
predecesores	predecesoras
gestores	gestoras
vampiros	vampiras
homónimos	homónimas
directivos	directivas
veteranos	veteranas
valencianos	valencianas
ladrones	ladronas
nativos	nativas
luchadores	luchadoras
presentadores	presentadoras
pioneros	pioneras
catedráticos	catedráticas
bancarios	bancarias
arqueros	arqueras
discípulos	discípulas
conejos	conejas
conejitos	conejitas
sospechosos	sospechosas
emprendedores	emprendedoras
esclavos	esclavas
espabilados	espabiladas
pícaros	pícaras
tunantes	tunantas
vencedores	vencedoras
exploradores	exploradoras
promotores	promotoras
contadores	contadoras
cazadores	cazadoras
distribuidores	distribuidoras
organizadores	organizadoras
legisladores	legisladoras
cirujanos	cirujanas
publicitarios	publicitarias
observadores	observadoras
comisarios	comisarias
pasajeros	pasajeras
opositores	opositoras
tutores	tutoras
primitivos	primitivas
millonarios	millonarias
dramaturgos	dramaturgas
seguidores	seguidoras
reguladores	reguladoras
magistrados	magistradas
empleadores	empleadoras
corderos	corderas
veterinarios	veterinarias
criados	criadas
redactores	redactoras
cantautores	cantautoras
portadores	portadoras
adversarios	adversarias
rubios	rubias
amorosos	amorosas
campesinos	campesinas
didácticos	didácticas
partidarios	partidarias
asturianos	asturianas
interinos	interinas
inventores	inventoras
toreros	toreras
estadísticos	estadísticas
pavos	pavas
deudores	deudoras
inspectores	inspectoras
desarrolladores	desarrolladoras
cuñados	cuñadas
infantes	infantas
astrónomos	astrónomas
tenedores	tenedoras
párrocos	párrocas
ibéricos	ibéricas
instructores	instructoras
mudos	mudas
borrachos	borrachas
consultores	consultoras
parientes	parientas
solteros	solteras
corruptos	corruptas
destinatarios	destinatarias
canarios	canarias
reporteros	reporteras
inversores	inversoras
emotivos	emotivas
serbios	serbias
estúpidos	estúpidas
payasos	payasas
constructores	constructoras
palestinos	palestinas
mojados	mojadas
precursores	precursoras
fracasados	fracasadas
guardianes	guardianas
enanos	enanas
acreedores	acreedoras
bizantinos	bizantinas
rústicos	rústicas
fanáticos	fanáticas
unitarios	unitarias
mensajeros	mensajeras
burros	burras
afiliados	afiliadas
ilustradores	ilustradoras
lanzadores	lanzadoras
graduados	graduadas
sudamericanos	sudamericanas
morenos	morenas
morenitos	morenitas
zorros	zorras
zorritos	zorritas
locutores	locutoras
antecesores	antecesoras
demandados	demandadas
raperos	raperas
procuradores	procuradoras
decanos	decanas
supervisores	supervisoras
místicos	místicas
mentores	mentoras
cachorros	cachorras
cachorritos	cachorritas
padrinos	madrinas
pescadores	pescadoras
notarios	notarias
subsecretarios	subsecretarias
beneficiarios	beneficiarias
siervos	siervas
marineros	marineras
salvadores	salvadoras
competidores	competidoras
sevillanos	sevillanas
patrocinadores	patrocinadoras
guerrilleros	guerrilleras
romeros	romeras
vagos	vagas
tiranos	tiranas
adictos	adictas
egresados	egresadas
patriarcas	matriarcas
carpinteros	carpinteras
seleccionadores	seleccionadoras
intermediarios	intermediarias
artesanos	artesanas
interlocutores	interlocutoras
mediadores	mediadoras
puertorriqueños	puertorriqueñas
andromedanos	andromedanas
conquistadores	conquistadoras
regidores	regidoras
correctores	correctoras
oradores	oradoras
cajeros	cajeras
exiliados	exiliadas
yernos	nueras
vigésimos	vigésimas
apoderados	apoderadas
jardineros	jardineras
burgueses	burguesas
ganaderos	ganaderas
pensadores	pensadoras
psíquicos	psíquicas
flacos	flacas
flaquitos	flaquitas
prematuros	prematuras
anotadores	anotadoras
noticieros	noticieras
navarros	navarras
agricultores	agricultoras
exportadores	exportadoras
tiradores	tiradoras
neoclásicos	neoclásicas
perdedores	perdedoras
colectores	colectoras
honorarios	honorarias
transmisores	transmisoras
ingenuos	ingenuas
murciélagos	murciélagas
eruditos	eruditas
destructores	destructoras
cofundadores	cofundadoras
ticos	ticas
jubilados	jubiladas
animadores	animadoras
cabrones	cabronas
clandestinos	clandestinas
peregrinos	peregrinas
instaladores	instaladoras
oriundos	oriundas
prefectos	prefectas
estudiosos	estudiosas
loros	loras
preparadores	preparadoras
auditores	auditoras
huérfanos	huérfanas
peones	peonas
sordos	sordas
laicos	laicas
tapados	tapadas
admiradores	admiradoras
limpiadores	limpiadoras
colorados	coloradas
multimillonarios	multimillonarias
refugiados	refugiadas
gatitos	gatitas
emuladores	emuladoras
subdirectores	subdirectoras
tesoreros	tesoreras
depredadores	depredadoras
progenitores	progenitoras
inquilinos	inquilinas
homólogos	homólogas
bárbaros	bárbaras
predicadores	predicadoras
sapos	sapas
coautores	coautoras
virtuosos	virtuosas
alcohólicos	alcohólicas
seductores	seductoras
escépticos	escépticas
comunicadores	comunicadoras
viceministros	viceministras
calvos	calvas
franciscanos	franciscanas
pillos	pillas
serranos	serranas
devotos	devotas
cantores	cantoras
paisanos	paisanas
diplomados	diplomadas
galeses	galesas
papis	mamis
papitos	mamitas
papacitos	mamacitas
topos	topas
antepasados	antepasadas
peritos	peritas
hoteleros	hoteleras
pendejos	pendejas
subordinados	subordinadas
rockeros	rockeras
mafiosos	mafiosas
letrados	letradas
desgraciados	desgraciadas
barceloneses	barcelonesas
recibidores	recibidoras
cuidadores	cuidadoras
rabinos	rabinas
vizcondes	vizcondesas
malagueños	malagueñas
francotiradores	francotiradoras
electores	electoras
exjugadores	exjugadoras
llaveros	llaveras
cautivos	cautivas
pelados	peladas
mendigos	mendigas
leoneses	leonesas
tigres	tigresas
extremeños	extremeñas
bomberos	bomberas
occitanos	occitanas
escribanos	escribanas
chiquitos	chiquitas
chiquititos	chiquititas
pequeñines	pequeñinas
chivos	chivas
libertarios	libertarias
camellos	camellas
vagabundos	vagabundas
aseguradores	aseguradoras
soñadores	soñadoras
operarios	operarias
paganos	paganas
mercenarios	mercenarias
inhibidores	inhibidoras
alpinos	alpinas
visionarios	visionarias
convertidores	convertidoras
vikingos	vikingas
cínicos	cínicas
tibetanos	tibetanas
ginecólogos	ginecólogas
ancestros	ancestras
centroamericanos	centroamericanas
mestizos	mestizas
formadores	formadoras
labradores	labradoras
matadores	matadoras
enfermeros	enfermeras
vegetarianos	vegetarianas
becarios	becarias
ositos	ositas
osos	osas
patitos	patitas
patos	patas
cerdos	cerdas
cerditos	cerditas
expositores	expositoras
geógrafos	geógrafas
precandidatos	precandidatas
manipuladores	manipuladoras
curadores	curadoras
infractores	infractoras
geólogos	geólogas
carteros	carteras
propulsores	propulsoras
mezcladores	mezcladoras
pedagogos	pedagogas
triunfadores	triunfadoras
facilitadores	facilitadoras
importadores	importadoras
bastardos	bastardas
transportadores	transportadoras
filólogos	filólogas
lexicográficos	lexicográficas
lexicológicos	lexicológicas
arrendatarios	arrendatarias
sureños	sureñas
panaderos	panaderas
violadores	violadoras
prelados	preladas
consoladores	consoladoras
reductores	reductoras
coreógrafos	coreógrafas
metafísicos	metafísicas
entrevistadores	entrevistadoras
libreros	libreras
prófugos	prófugas
gringos	gringas
asnos	asnas
germanos	germanas
bisabuelos	bisabuelas
abuelitos	abuelitas
principitos	princesitas
eclécticos	eclécticas
integradores	integradoras
manchegos	manchegas
hidalgos	hidalgas
fugitivos	fugitivas
priores	prioras
repartidores	repartidoras
coquetos	coquetas
homenajeados	homenajeadas
basureros	basureras
marcianos	marcianas
venusinos	venusinas
saturnianos	saturnianas
abridores	abridoras
negociadores	negociadoras
cinéfilos	cinéfilas
reparadores	reparadoras
interventores	interventoras
arameos	arameas
disparadores	disparadoras
divorciados	divorciadas
dispersos	dispersas
platónicos	platónicas
emigrados	emigradas
norteños	norteñas
gaditanos	gaditanas
intrusos	intrusas
peatones	peatonas
profanos	profanas
barberos	barberas
libertadores	libertadoras
hermanastros	hermanastras
pervertidos	pervertidas
confesores	confesoras
astrólogos	astrólogas
provocadores	provocadoras
marginados	marginadas
piscos	piscas
superintendentes	superintendentas
corsos	corsas
camioneros	camioneras
prusianos	prusianas
estafadores	estafadoras
multiplicadores	multiplicadoras
archiduques	archiduquesas
bandidos	bandidas
bloqueadores	bloqueadoras
relatores	relatoras
riojanos	riojanas
cantaores	cantaoras
bateadores	bateadoras
potros	potras
analizadores	analizadoras
beatos	beatas
postores	postoras
politólogos	politólogas
obesos	obesas
californianos	californianas
benefactores	benefactoras
vicegobernadores	vicegobernadoras
ex-presidentes	ex-presidentas
expresidentes	expresidentas
copresidentes	copresidentas
gansos	gansas
paleontólogos	paleontólogas
acumuladores	acumuladoras
perseguidores	perseguidoras
cornudos	cornudas
usurpadores	usurpadoras
liberadores	liberadoras
forasteros	forasteras
discapacitados	discapacitadas
bretones	bretonas
sicarios	sicarias
escandinavos	escandinavas
lusos	lusas
perturbadores	perturbadoras
secuestradores	secuestradoras
fulanos	fulanas
síndicos	síndicas
peloteros	peloteras
joyeros	joyeras
acomodados	acomodadas
hacendados	hacendadas
emisarios	emisarias
matones	matonas
orientadores	orientadoras
agrónomos	agrónomas
literatos	literatas
arrendadores	arrendadoras
desempleados	desempleadas
inquisidores	inquisidoras
comendadores	comendadoras
roperos	roperas
benedictinos	benedictinas
dermatólogos	dermatólogas
bioquímicos	bioquímicas
canteranos	canteranas
cortesanos	cortesanas
ideólogos	ideólogas
conselleres	conselleras
registradores	registradoras
llaneros	llaneras
redentores	redentoras
cabritos	cabritas
bisnietos	bisnietas
tuertos	tuertas
florentinos	florentinas
corsarios	corsarias
pupilos	pupilas
musicólogos	musicólogas
kurdos	kurdas
conciliadores	conciliadoras
impostores	impostoras
chiquillos	chiquillas
repetidores	repetidoras
suburbanos	suburbanas
contralores	contraloras
recolectores	recolectoras
imitadores	imitadoras
analfabetos	analfabetas
suscriptores	suscriptoras
probadores	probadoras
inexpertos	inexpertas
napolitanos	napolitanas
armadores	armadoras
iberoamericanos	iberoamericanas
sicilianos	sicilianas
reformadores	reformadoras
proletarios	proletarias
genoveses	genovesas
retrógrados	retrógradas
vicerrectores	vicerrectoras
planificadores	planificadoras
hacedores	hacedoras
espartanos	espartanas
novilleros	novilleras
chanchos	chanchas
zaragozanos	zaragozanas
fenicios	fenicias
hispanoamericanos	hispanoamericanas
bicampeones	bicampeonas
salmantinos	salmantinas
conversos	conversas
eurodiputados	eurodiputadas
bávaros	bávaras
cerveceros	cerveceras
gladiadores	gladiadoras
agraciados	agraciadas
esquiadores	esquiadoras
pobrecitos	pobrecitas
búfalos	búfalas
suramericanos	suramericanas
maltratadores	maltratadoras
insensatos	insensatas
sensatos	sensatas
drogadictos	drogadictas
becados	becadas
lecheros	lecheras
tomadores	tomadoras
charros	charras
metalúrgicos	metalúrgicas
metaleros	metaleras
calculadores	calculadoras
criadores	criadoras
manufactureros	manufactureras
incomprendidos	incomprendidas
convictos	convictas
cartagineses	cartaginesas
tarados	taradas
meseros	meseras
mulatos	mulatas
avaros	avaras
cartógrafos	cartógrafas
introvertidos	introvertidas
abusadores	abusadoras
activadores	activadoras
decoradores	decoradoras
surtidores	surtidoras
examinadores	examinadoras
testadores	testadoras
asirios	asirias
visitadores	visitadoras
prestatarios	prestatarias
mejicanos	mejicanas
montañeros	montañeras
anunciadores	anunciadoras
remolcadores	remolcadoras
toscanos	toscanas
subalternos	subalternas
recaudadores	recaudadoras
vengadores	vengadoras
finados	finadas
futboleros	futboleras
vicesecretarios	vicesecretarias
hipopótamos	hipopótamas
paralíticos	paralíticas
bebedores	bebedoras
ochentenos	ochentenas
escenógrafos	escenógrafas
xenófobos	xenófobas
cabezones	cabezonas
normandos	normandas
drogados	drogadas
siberianos	siberianas
hawaianos	hawaianas
exsecretarios	exsecretarias
chatos	chatas
reclusos	reclusas
agnósticos	agnósticas
ingratos	ingratas
pijos	pijas
borregos	borregas
desertores	desertoras
jornaleros	jornaleras
benjamines	benjaminas
transgresores	transgresoras
codirectores	codirectoras
salseros	salseras
sádicos	sádicas
chiflados	chifladas
trepadores	trepadoras
desalojados	desalojadas
micólogos	micólogas
fiadores	fiadoras
presumidos	presumidas
continuadores	continuadoras
colonizadores	colonizadoras
bandoleros	bandoleras
desamparados	desamparadas
dadores	dadoras
preceptores	preceptoras
oidores	oidoras
lombardos	lombardas
neuróticos	neuróticas
hospedadores	hospedadoras
leprosos	leprosas
súbditos	súbditas
pitufos	pitufas
meteorólogos	meteorólogas
sumerios	sumerias
titiriteros	titiriteras
filosofos	filosofas
jorobados	jorobadas
pasteleros	pasteleras
entomólogos	entomólogas
pedófilos	pedófilas
moriscos	moriscas
cholos	cholas
occisos	occisas
suministradores	suministradoras
esquizofrénicos	esquizofrénicas
explotadores	explotadoras
comuneros	comuneras
guarros	guarras
incendiarios	incendiarias
segovianos	segovianas
carceleros	carceleras
victimarios	victimarias
cobradores	cobradoras
patinadores	patinadoras
tejanos	tejanas
gamberros	gamberras
manejadores	manejadoras
colchoneros	colchoneras
histéricos	histéricas
llorones	lloronas
jónicos	jónicas
torturadores	torturadoras
anglicanos	anglicanas
rancheros	rancheras
checoslovacos	checoslovacas
samaritanos	samaritanas
visualizadores	visualizadoras
devoradores	devoradoras
templarios	templarias
rastreadores	rastreadoras
montadores	montadoras
andadores	andadoras
milicianos	milicianas
pobladores	pobladoras
clasificadores	clasificadoras
estimuladores	estimuladoras
salesianos	salesianas
libertinos	libertinas
gregarios	gregarias
pololos	pololas
indoeuropeos	indoeuropeas
euroasiáticos	euroasiáticas
eurasiáticos	eurasiáticas
telemáticos	telemáticas
plebeyos	plebeyas
cultivadores	cultivadoras
urólogos	urólogas
lechones	lechonas
petardos	petardas
adeptos	adeptas
neurocirujanos	neurocirujanas
introductores	introductoras
fariseos	fariseas
evangelizadores	evangelizadoras
reboteadores	reboteadoras
trinitarios	trinitarias
superdotados	superdotadas
gruñones	gruñonas
ortopédicos	ortopédicas
cocheros	cocheras
tranquilizadores	tranquilizadoras
cretinos	cretinas
necios	necias
tercos	tercas
obstinados	obstinadas
testarudos	testarudas
oncólogos	oncólogas
encomenderos	encomenderas
coruñeses	coruñesas
neonatos	neonatas
molineros	molineras
mañaneros	mañaneras
cantoneses	cantonesas
mochileros	mochileras
exdiputados	exdiputadas
supervillanos	supervillanas
superhéroes	superheroínas
limoneros	limoneras
pichones	pichonas
enólogos	enólogas
lacayos	lacayas
mamones	mamonas
teloneros	teloneras
informadores	informadoras
arrieros	arrieras
mesoamericanos	mesoamericanas
boticarios	boticarias
cantábricos	cantábricas
picadores	picadoras
muchachitos	muchachitas
hombrecitos	mujercitas
maños	mañas
demagogos	demagogas
indianos	indianas
archiveros	archiveras
cuates	cuatas
instigadores	instigadoras
afinadores	afinadoras
barqueros	barqueras
apáticos	apáticas
depravados	depravadas
catetos	catetas
cancerberos	cancerberas
arios	arias
exterminadores	exterminadoras
texanos	texanas
patólogos	patólogas
tejedores	tejedoras
rectificadores	rectificadoras
agrimensores	agrimensoras
costeños	costeñas
retardados	retardadas
delatores	delatoras
acusadores	acusadoras
indocumentados	indocumentadas
documentados	documentadas
conspiradores	conspiradoras
excandidatos	excandidatas
celadores	celadoras
neófitos	neófitas
sorianos	sorianas
traumatólogos	traumatólogas
recuperadores	recuperadoras
tricampeones	tricampeonas
vividores	vividoras
peticionarios	peticionarias
valedores	valedoras
armeros	armeras
jurisconsultos	jurisconsultas
estimadores	estimadoras
mixtecos	mixtecas
milaneses	milanesas
pardillos	pardillas
ribereños	ribereñas
pirotécnicos	pirotécnicas
cosacos	cosacas
morosos	morosas
supresores	supresoras
especuladores	especuladoras
reclutadores	reclutadoras
jefazos	jefazas
posaderos	posaderas
blasfemos	blasfemas
tertulianos	tertulianas
maníacos	maníacas
fiscalizadores	fiscalizadoras
tatarabuelos	tatarabuelas
copropietarios	copropietarias
mellizos	mellizas
perpetradores	perpetradoras
freudianos	freudianas
donadores	donadoras
taquilleros	taquilleras
paramédicos	paramédicas
mormones	mormonas
bodegueros	bodegueras
maquilladores	maquilladoras
captores	captoras
novicios	novicias
rejoneadores	rejoneadoras
atracadores	atracadoras
dobladores	dobladoras
tipejos	tipejas
homofóbicos	homofóbicas
etnólogos	etnólogas
frigios	frigias
archivadores	archivadoras
substitutos	substitutas
malcriados	malcriadas
tecnólogos	tecnólogas
primerizos	primerizas
montenegrinos	montenegrinas
tatuadores	tatuadoras
mamarrachos	mamarrachas
octogenarios	octogenarias
puritanos	puritanas
egiptólogos	egiptólogas
aritméticos	aritméticas
carroceros	carroceras
lunáticos	lunáticas
tasadores	tasadoras
